"IBAN/BBAN","Munt","BIC","Volgnr","Datum","Rentedatum","Bedrag","Saldo na trn","Tegenrekening IBAN/BBAN","Naam tegenpartij","Naam uiteindelijke partij","Naam initierende partij","BIC tegenpartij","Code","Batch ID","Transactiereferentie","Machtigingskenmerk","Incassant ID","Betalingskenmerk","Omschrijving-1","Omschrijving-2","Omschrijving-3","Reden retour","Oorspr bedrag","Oorspr munt","Koers"
"NL75RABO0326631364","EUR","RABONL2U","000000000000008823","2021-10-02","2021-10-01","-45,30","+29829,30","","Kosten","","","","db","","","","","","Periode 01-09-2021 t/m 30-09-2021"," ","","","","",""
"NL75RABO0326631364","EUR","RABONL2U","000000000000008824","2021-10-03","2021-10-04","-5,81","+29823,49","NL87ABNA0595476562","X. wdfgewrfg","","Rabobank Nederland APO","ABNANL2AXXX","bg","","","","","","Bijdrage BIHZ-sponsoren.nl live"," ","","","","",""
"NL75RABO0326631364","EUR","RABONL2U","000000000000008825","2021-10-03","2021-10-03","+2000,00","+31823,49","NL58RABO0155138677","Bedrijf X","","","RABONL2U","cb","","","","","","debiteur 06735 ambassadeur"," ","","","","",""
"NL75RABO0326631364","EUR","RABONL2U","000000000000008826","2021-10-04","2021-10-04","+813,41","+32636,90","DE26512202000071418016","PAYPAL PTE. LTD","","","ESSEDEFF","cb","","128146125","","","","Stichting Bergh in"," ","","","","",""
"NL75RABO0326631364","EUR","RABONL2U","000000000000008827","2021-10-05","2021-10-05","+2000,00","+34636,90","NL72ABNA0533016398","Bedrijf Y BV","","","ABNANL2A","cb","","","","","","01092"," ","","","","",""
"NL75RABO0326631364","EUR","RABONL2U","000000000000008828","2021-10-06","2021-10-06","-18,15","+34618,75","NL02RABO0129284432","Bedrijf Z B.V.","","","RABONL2U","ei","","M84988f3b-283b-40fd-B05019-T0775866","13003085-1","NL83ZZZ341282610000","","13003085/2895144"," ","","","","",""
"NL75RABO0326631364","EUR","RABONL2U","000000000000008829","2021-10-06","2021-10-06","+1112,53","+35731,28","NL29ABNA0546842291","Kentaa","","","ABNANL2A","cb","","2753615bf75bdb9773.72540431","","","","REF T11905677.2110.01"," ","","","","",""
"NL75RABO0326631364","EUR","RABONL2U","000000000000008830","2021-10-07","2021-10-07","-61,02","+35670,26","NL60RABO0300281390","Bedrijf P","","","RABONL2U","ei","","057668323475","000200024946","NL67ZZZ080534100004","","Zeza Polis 148494707 Periode 01.10.2021 - 01.11.2021 Interpolis"," ","","","","",""
